0,0,0,0,0,0,3,0,0
0,0,0,0,7,1,5,0,0
0,0,2,4,0,0,0,1,8
0,0,0,0,0,9,0,4,0
0,9,0,6,1,8,2,3,0
6,1,0,7,0,0,0,0,0
4,3,0,8,0,7,6,0,0
0,0,8,1,4,0,0,0,0
0,0,9,0,0,0,0,0,0